10 10
1 1 1 1 1 1 1 1 1 1 
1 0 0 0 0 0 0 0 0 1 
1 0 0 0 0 4 0 0 0 1 
1 0 0 0 0 8 0 0 0 1 
1 0 0 0 0 0 0 0 0 1 
1 0 4 0 0 0 0 4 0 1 
1 0 0 0 2 2 3 0 0 1 
1 0 0 0 3 0 0 0 0 1 
1 0 0 0 0 0 0 0 0 1 
1 1 1 1 1 1 1 1 1 1 
8